11111111111111111111
10000000000000000001
10000c0000000p000001
10000000000000000001
1c000000000000000001
11111111011111111111
10000e00000000000001
1000000000000c000001
11111111111111111111
