11111111111111111111
10000000000000000001
10000c00000000000001
10000000000000000001
100000000p0000000001
11111111011111111111
10000e00000000000001
10000000000000000001
11111111111111111111
