1111111
1p00001
10ccc01
10000e1
1111111
