11111111111111111111
10C000001000000000E1
10000000100000000001
10000000100000000001
100000P0100000000001
10000000000000000001
11111111111111111111
11111111111111111111
11111111111111111111
