11111111111111111111
10000000000000100001
10000000000000100c01
10000000000000100001
1111111111111p100001
10000000000000100111
10000000000000100001
1e000000000000000001
11111111111111111111
