1111111111111
1P00000000C01
1000111110001
1C00100001E01
1000100000001
1000111110001
1C00000000C01
1111111111111
