111111111111
1P0000000C01
100111100001
1C0001000E01
100010000001
100011111001
100000000C01
1C0000000001
111111111111
