11111111111111111111
1P00000000000000C0E1
10001111111110000001
1C000100000100000001
10001000111010000001
10001100001010000001
10000000001010000001
1011100000101000C001
1C000000000100000001
10000000000000000001
10000000000000000001
11111111111111111111
